00000000000003300000002200000000000000
00022044400000000300002233000000000000
00022044400000330300302200000003300000
00000220000000022022302200000000000000
00000220000000022022220000022000000000
00000000000000000000220000022000000000
00000440000220030000000000000022000000
00000440000220033000003300000022000000
00000440022000003000000022000000000000
00000000022000330000000022000000000033
00000000000300000000000000000000000000
00000000000300000003000000000000000022
00000000000000044003220000000002222022
00000000000000044000220000220002222000
00000223300000044000000022220000022000
00220220000000000033000022003300022000
22220000000022000000000000000000000000
22000000000022022220000000000000000000
00000000000000022220000000000440000000
00000000000000000330000000000440000000
00000000000000000033000000000440000000
22000330022000000000000000000000000000
22000022022000022220003300000000000000
00000022000000022220000000000000000000
