00220000000033000000000000022330000000
00220000022000000000000000022000000000
00000300022000000000000030000000000000
00000302200000000000000030000000000000
00000002200000033000000220000000220440
00220000000003000000000220000000220440
00220000000003022000000000000003000440
04400002200000022000220022000003220000
04444402200000000220220022022000220000
04444400022000000220033033022000022220
00000000022022000022000022003300022220
02222000000022000022000022000000000000
02222000220000000000000004400000330000
00000000220000000000000004400000000000
00000000000000000000000004400000300000
00000000000220000000330000000000300000
00022000000220000000000000000000000000
00022000002200000000000000000000022000
00000000002200000000000003300000022000
22000000000000303300330000000000000000
22000000000000300000000000000000000000
00000000000000222200000000000000000000
00000000003300222200000000000000000300
00000000000000000003300000000000000300
