00002200000000000000000000002200000000
00002200000000000002200000002200000220
00000000000000000002200000000000000220
00030220000000000000000002200022000440
00030220000000000000000002200022044440
00022000000000000000330440000000044440
00022000000000000033000440220000044000
00000030000022000000000440220220220000
00000030000022000000000000000220220000
00000000000000000000022002200000000030
00000300000000220000022002200000000030
00000300000000220000022000000033000000
00000000000000000022022300000000000300
22000000220000000022000300000000444300
22002200220000000000000000000000444003
00002200000000030000000002202200002203
00000000033000030000000002202200002200
02200000000000000000000000000220000000
02200000000000000000000220000220000033
00000000030000222200000220000000000033
03000003030000222200000000002200300000
03000003000000000000003300002200300000
00000000000002200000000300000000000000
00000000000002200000000300000000000000
