02200000030000033000000000000220002200
02200000030000000000000000000220002200
00000000000000000022030330000033000000
00000000000000000022030000000000022000
22220000000000000000000000000000022000
22220000002200000000000000330000000000
00000002202200022000000000000000000000
00000002200000022000000000000000044400
00000000000000330000000000002200044400
00000223000000000000000000002200000000
00000223000000022000000000000000000220
00000004440000022000000220300000000220
00000004440000000000220220300000000000
00220000000000000000220033000044400000
00220000030000000000000000000044400000
03300003330000000000000000000000000000
00000000000000000000000003003000000000
02200000000000044000000003223000000022
02200222200000044000000300220000000022
00000222202200044000000322002222000300
00000000002200000000000022002222000300
00000000000000000000000220000000002200
00000220000300000003300222200000002200
00000220000300000000000002200003300000
