00000000000000000000000000000000000022
00000000000000000022000000030220000022
00000220000000000022000000030220000033
00000220030000000000000000000000002200
00022000030223000220000000000000002200
00022000000223000220002233000002200000
00000000000000022000002222000002200000
00000000022000022044000022000000000000
00033000022000220044000000000000000000
00000000000003220044000000000000000000
00004400000003000003322000000000000000
00004400000000000000022000022000440000
00334400000220000000000000022000440000
00000000000220030000000000000000440000
00000000000004430000003033000000000000
00000000000004400000003000000002200000
00000000000224400000000003022002200000
03300000000222200022000003022000000000
00000000022002200022220000000000330000
00000000022000000000220000000000000000
00000000000000002222000000000000000220
00000000000220002222000003000022000220
00022000000220000000003003003322000000
00022000000000003300003000000033000000
