00000000000000000000330030000000000000
00002200000000000000000030000000000000
00002200002200000330000000000000000000
00022000002200000322003000000022034440
00022000000000000322003000222222034440
00000033003000000000000022222202202200
00000000003022000000000022000002202200
00000000022022000000033000000000000000
22000000022000000000000000000000022000
22000000000000000000000000000000022000
00000000002200000000000000000000330000
22000003002200000000220000000000022000
22000003000000000220220000000000022000
00000000000000000220003000000000000000
00330000000000000220003000000000000000
00000000003300000220000000000000022000
00000000000000000000000333300002222000
00044400000003300000220000000002200000
00044400000220000000220022220000000000
00220000000220000000000022220044400000
00220000000000220004440220000044400000
00220003300000220004440220000000000000
00220000000000000000000000000000300330
00000000000000000000000000000000300000
